1111111111111111111111
100P00C100C00110010011
1000100001001000000001
1000100001001000000011
1000100001001000000001
10C010001100100C00C0E1
1111111111111111111111