1111111111111111111111
10000C100C000000100111
1P00100001001000000001
100C100001001001000001
100010C001001000000001
10C010001100100C00C0E1
1111111111111111111111