1111111111111111111111
10P0000100000010010011
1000100001001000000001
1000100001001000000001
1000100001C01000000001
10001000110010000000E1
1111111111111111111111