1111111111111111111111
100P00C100C00010010011
1000100001001000000001
1C0010001100100C00C0E1
1111111111111111111111