1111111111111111111111
100p00C100C00010010011
1000100001001000000001
100c100001001001000001
100010C001001000000001
10C010001100100C00C0e1
1111111111110111111111